id
1
name
Starting Village
size
32 32
tiles
00 05 05 05 05 05 05 05 05 05 05 05 05 05 05 05 05 05 05 05 05 05 05 05 05 05 05 05 05 05 05 02
03 67 67 67 67 67 64 64 64 64 64 64 64 64 64 64 64 64 64 64 62 62 62 62 62 62 62 62 62 62 62 03
03 67 62 62 62 67 64 64 64 64 64 64 64 67 67 67 67 67 67 64 62 62 62 62 62 62 62 62 62 62 62 03
03 67 62 62 62 67 64 64 64 65 64 64 64 67 62 62 62 62 67 64 62 62 62 62 62 62 62 62 62 62 62 03
03 67 62 62 62 67 64 64 64 64 64 64 64 67 62 62 62 62 67 64 62 62 62 62 62 62 62 62 62 62 62 03
03 67 62 62 62 67 64 64 65 64 65 64 64 67 62 62 62 62 67 64 62 62 62 62 62 62 62 62 62 62 62 03
03 67 67 63 67 67 64 64 64 64 64 64 64 67 63 67 67 67 67 64 62 62 62 62 62 62 62 62 62 62 62 03
03 62 62 62 62 62 62 62 62 62 62 62 62 62 64 64 64 64 64 64 64 62 62 62 62 62 62 62 62 62 62 03
03 62 62 62 62 62 62 62 62 62 62 62 62 62 64 64 64 64 64 64 64 64 64 64 64 64 64 64 64 64 64 03
03 67 67 63 67 67 67 67 67 62 62 62 62 62 64 64 64 64 64 64 64 64 64 64 64 64 64 64 64 64 64 03
03 67 62 62 62 62 62 62 67 64 64 64 64 64 64 64 64 64 64 64 64 64 64 64 64 64 64 64 64 64 64 03
03 67 62 62 62 62 62 62 67 64 64 64 64 64 64 64 64 64 64 64 64 64 64 64 64 64 64 64 64 64 64 03
03 67 62 62 62 67 67 67 67 64 64 64 64 64 64 00 05 54 62 53 05 02 64 64 64 64 64 64 64 64 64 03
03 67 62 62 62 67 64 64 64 64 64 64 64 64 64 03 64 64 64 64 64 03 64 64 64 64 64 64 64 64 64 55
03 67 62 62 62 67 64 64 64 64 64 64 64 64 64 03 64 64 64 64 64 16 05 05 05 05 05 02 64 64 64 62
03 67 67 67 67 67 64 64 64 64 64 64 64 64 64 03 64 64 64 64 64 64 64 64 64 64 64 03 64 64 64 62
03 64 64 64 64 64 64 64 64 64 64 64 64 64 64 03 64 64 64 64 64 64 64 64 64 64 64 03 64 64 64 56
08 54 63 53 01 05 05 05 05 05 05 02 62 62 62 03 64 64 64 64 61 64 64 64 64 64 64 16 05 05 05 18
03 62 62 62 03 64 64 64 64 64 64 03 62 62 62 03 64 64 61 61 61 61 64 64 64 64 64 64 64 64 64 61
08 05 05 05 18 64 64 64 64 64 64 16 05 05 05 18 64 64 64 61 61 61 61 64 64 64 64 64 64 64 61 61
03 64 64 64 64 64 64 64 64 64 64 64 64 64 64 64 58 64 64 64 61 61 64 64 64 64 64 64 61 61 61 61
03 64 64 64 64 64 64 64 64 64 64 64 64 64 64 64 58 58 64 64 64 61 64 64 64 64 64 64 64 61 61 61
03 64 64 64 64 64 64 64 64 64 64 64 64 64 58 58 58 58 64 64 64 64 64 64 64 64 64 64 64 64 61 61
03 64 71 77 77 77 74 64 64 64 64 64 64 64 58 58 58 64 64 64 64 64 64 64 64 64 64 64 64 64 60 61
03 64 76 64 64 64 76 64 64 64 64 64 65 64 64 58 64 64 64 64 64 64 64 64 64 64 64 64 64 60 60 61
77 77 73 64 64 64 64 64 64 64 64 64 65 65 64 64 64 64 64 64 64 64 64 64 64 64 64 60 60 60 57 57
03 64 64 64 64 64 64 64 64 64 64 64 65 65 64 64 64 64 64 64 64 64 64 64 64 64 60 60 60 57 57 57
03 64 64 64 64 64 64 64 64 64 66 66 65 65 65 64 64 64 64 64 64 64 64 64 64 60 60 57 57 57 57 57
03 64 64 64 64 64 64 64 64 64 66 65 65 64 65 65 64 64 64 64 64 64 64 64 60 60 57 57 57 57 57 57
03 64 64 64 64 64 64 64 64 64 64 64 64 64 64 65 64 64 64 64 64 64 64 60 60 57 57 57 57 57 57 57
03 64 64 64 64 64 64 64 64 64 64 64 64 64 64 64 64 64 64 64 64 64 60 60 57 57 57 57 57 57 57 57
16 05 05 05 05 05 05 05 05 05 05 05 05 05 05 05 05 05 05 05 05 05 05 54 57 57 57 57 57 57 57 57
colors
11 11 11 11 11 11 11 11 11 11 11 11 11 11 11 11 11 11 11 11 11 11 11 11 11 11 11 11 11 11 11 11
11 15 15 15 15 15 32 32 32 32 32 32 32 32 32 32 32 32 32 32 01 01 01 01 01 01 01 01 01 01 01 11
11 15 11 11 11 15 32 32 32 32 32 32 32 15 15 15 15 15 15 32 01 01 01 01 01 01 01 01 01 01 01 11
11 15 11 11 11 15 32 32 32 32 32 32 32 15 11 11 11 11 15 32 01 01 01 01 01 01 01 01 01 01 01 11
11 15 11 11 11 15 32 32 32 32 32 32 32 15 11 11 11 11 15 32 01 01 01 01 01 01 01 01 01 01 01 11
11 15 11 11 11 15 32 32 32 32 32 32 32 15 11 11 11 11 15 32 01 01 01 01 01 01 01 01 01 01 01 11
11 15 15 01 15 15 32 32 32 32 32 32 32 15 01 15 15 15 15 32 01 01 01 01 01 01 01 01 01 01 01 11
11 01 01 01 01 01 01 01 01 01 01 01 01 01 01 01 01 01 01 01 01 01 01 01 01 01 01 01 01 01 01 11
11 01 01 01 01 01 01 01 01 01 01 01 01 01 01 01 01 01 01 01 01 01 01 01 01 01 01 01 01 01 01 11
11 15 15 01 15 15 15 15 15 01 01 01 01 01 01 01 01 01 01 01 01 01 01 01 01 01 01 01 01 01 01 11
11 15 11 11 11 11 11 11 15 01 01 01 01 01 01 01 01 01 01 01 01 01 01 01 01 01 01 01 01 01 01 11
11 15 11 11 11 11 11 11 15 32 32 32 32 32 32 01 01 01 01 01 01 01 01 01 01 01 01 01 01 01 01 11
11 15 11 11 11 15 15 15 15 32 32 32 32 32 32 01 01 01 01 01 01 01 01 01 01 01 01 01 01 01 01 11
11 15 11 11 11 15 15 15 15 32 32 32 32 32 32 01 01 01 01 01 01 01 01 01 01 01 01 01 01 01 01 11
11 15 11 11 11 15 32 32 32 32 32 32 32 32 32 01 01 01 01 01 01 01 01 01 01 01 01 01 01 01 01 11
11 15 15 15 15 15 32 32 32 32 32 32 32 32 32 11 01 01 01 01 01 01 01 01 01 01 01 01 01 01 01 11
11 32 32 32 32 32 32 32 32 32 32 32 32 32 32 11 01 01 01 01 01 01 01 01 01 01 01 01 01 01 01 11
11 11 11 11 11 11 11 11 11 11 11 11 11 11 11 11 01 01 01 01 32 01 01 01 01 01 01 01 01 01 01 11
11 11 11 11 11 01 01 01 01 01 01 11 11 11 11 11 01 01 32 32 32 32 01 01 01 01 01 01 01 01 01 32
11 11 11 11 11 01 01 01 01 01 01 11 11 11 11 11 01 01 01 32 32 32 32 01 01 01 01 01 01 01 32 32
11 01 01 01 01 01 01 01 01 01 01 01 01 01 01 01 01 01 01 01 32 32 32 32 32 32 32 32 32 32 32 32
11 01 01 01 01 01 01 01 01 01 01 01 01 01 01 01 01 01 01 01 01 32 32 32 32 32 32 32 32 32 32 32
11 32 32 32 32 32 32 32 32 32 32 32 32 32 32 32 32 32 32 32 32 32 32 32 32 32 32 32 32 32 32 32
15 32 32 32 32 32 32 32 32 34 32 32 32 32 32 32 32 32 33 32 32 32 32 32 32 32 32 32 32 32 36 32
15 32 32 32 32 32 32 32 33 34 32 32 32 32 32 33 32 32 32 32 32 32 32 32 32 32 34 32 32 36 35 32
15 32 32 32 32 32 32 32 33 32 32 32 32 32 32 32 32 32 32 33 33 32 32 32 32 32 32 36 36 35 20 20
15 32 32 32 32 32 32 32 32 32 32 32 32 32 32 32 32 32 32 32 33 32 32 32 32 32 36 35 35 20 20 20
15 32 32 32 32 32 32 32 32 32 32 32 32 32 32 32 32 32 32 33 34 32 32 32 32 36 35 20 20 20 20 20
15 32 32 32 32 32 32 32 32 32 34 34 32 32 32 32 32 32 32 32 32 32 32 32 36 35 20 20 20 20 20 20
15 32 32 32 32 32 32 32 32 32 33 32 32 32 33 32 32 32 32 32 32 32 32 36 35 20 20 20 20 20 20 20
15 32 32 32 32 32 32 32 32 32 32 33 32 33 32 32 32 32 32 32 32 32 36 35 20 20 20 20 20 20 20 20
15 15 15 15 15 15 15 15 15 15 15 15 15 15 15 15 15 15 15 15 15 15 15 15 20 20 20 20 20 20 20 20
functions
00 00 00 00 00 00 00 00 00 00 00 00 00 00 00 00 00 00 00 00 00 00 00 00 00 00 00 00 00 00 00 00
00 00 00 00 00 00 00 00 00 00 00 00 00 00 00 00 00 00 00 00 00 00 00 00 00 00 00 00 00 00 00 00
00 00 00 00 00 00 00 00 00 00 00 00 00 00 00 00 00 00 00 00 00 00 00 00 00 00 00 00 00 00 00 00
00 00 00 00 00 00 00 00 00 00 00 00 00 00 00 00 00 00 00 00 00 00 00 00 00 00 00 00 00 00 00 00
00 00 00 00 00 00 00 00 00 00 00 00 00 00 00 00 00 00 00 00 00 00 00 00 00 00 00 00 00 00 00 00
00 00 00 00 00 00 00 00 00 00 00 00 00 00 00 00 00 00 00 00 00 00 00 00 00 00 00 00 00 00 00 00
00 00 00 00 00 00 00 00 00 00 00 00 00 00 00 00 00 00 00 00 00 00 00 00 00 00 00 00 00 00 00 00
00 00 00 00 00 00 00 00 00 00 00 00 00 00 00 00 00 00 00 00 00 00 00 00 00 00 00 00 00 00 00 00
00 00 00 00 00 00 00 00 00 00 00 00 00 00 00 00 00 00 00 00 00 00 00 00 00 00 00 00 00 00 00 00
00 00 00 00 00 00 00 00 00 00 00 00 00 00 00 00 00 00 00 00 00 00 00 00 00 00 00 00 00 00 00 00
00 00 00 00 00 00 00 00 00 00 00 00 00 00 00 00 00 00 00 00 00 00 00 00 00 00 00 00 00 00 00 00
00 00 00 00 00 00 00 00 00 00 00 00 00 00 00 00 00 00 00 00 00 00 00 00 00 00 00 00 00 00 00 00
00 00 00 00 00 00 00 00 00 00 00 00 00 00 00 00 00 00 00 00 00 00 00 00 00 00 00 00 00 00 00 00
00 00 00 00 00 00 00 00 00 00 00 00 00 00 00 00 00 00 00 00 00 00 00 00 00 00 00 00 00 00 00 00
00 00 00 00 00 00 00 00 00 00 00 00 00 00 00 00 00 00 00 00 00 00 00 00 00 00 00 00 00 00 00 00
00 00 00 00 00 00 00 00 00 00 00 00 00 00 00 00 00 00 00 00 00 00 00 00 00 00 00 00 00 00 00 00
00 00 00 00 00 00 00 00 00 00 00 00 00 00 00 00 00 00 00 00 00 00 00 00 00 00 00 00 00 00 00 00
00 00 00 00 00 00 00 00 00 00 00 00 00 00 00 00 00 00 00 00 00 00 00 00 00 00 00 00 00 00 00 00
00 00 00 00 00 00 00 00 00 00 00 00 00 00 00 00 00 00 00 00 00 00 00 00 00 00 00 00 00 00 00 00
00 00 00 00 00 00 00 00 00 00 00 00 00 00 00 00 00 00 00 00 00 00 00 00 00 00 00 00 00 00 00 00
00 00 00 00 00 00 00 00 00 00 00 00 00 00 00 00 00 00 00 00 00 00 00 00 00 00 00 00 00 00 00 00
00 00 00 00 00 00 00 00 00 00 00 00 00 00 00 00 00 00 00 00 00 00 00 00 00 00 00 00 00 00 00 00
00 00 00 00 00 00 00 00 00 00 00 00 00 00 00 00 00 00 00 00 00 00 00 00 00 00 00 00 00 00 00 00
00 00 00 00 00 00 00 00 00 00 00 00 00 00 00 00 00 00 00 00 00 00 00 00 00 00 00 00 00 00 00 00
00 00 00 00 00 00 00 00 00 00 00 00 00 00 00 00 00 00 00 00 00 00 00 00 00 00 00 00 00 00 00 00
00 00 00 00 00 00 00 00 00 00 00 00 00 00 00 00 00 00 00 00 00 00 00 00 00 00 00 00 00 00 00 00
00 00 00 00 00 00 00 00 00 00 00 00 00 00 00 00 00 00 00 00 00 00 00 00 00 00 00 00 00 00 00 00
00 00 00 00 00 00 00 00 00 00 00 00 00 00 00 00 00 00 00 00 00 00 00 00 00 00 00 00 00 00 00 00
00 00 00 00 00 00 00 00 00 00 00 00 00 00 00 00 00 00 00 00 00 00 00 00 00 00 00 00 00 00 00 00
00 00 00 00 00 00 00 00 00 00 00 00 00 00 00 00 00 00 00 00 00 00 00 00 00 00 00 00 00 00 00 00
00 00 00 00 00 00 00 00 00 00 00 00 00 00 00 00 00 00 00 00 00 00 00 00 00 00 00 00 00 00 00 00
00 00 00 00 00 00 00 00 00 00 00 00 00 00 00 00 00 00 00 00 00 00 00 00 00 00 00 00 00 00 00 00
walkable
00 00 00 00 00 00 00 00 00 00 00 00 00 00 00 00 00 00 00 00 00 00 00 00 00 00 00 00 00 00 00 00
00 01 01 01 01 01 01 01 01 01 01 01 01 01 01 01 01 01 01 01 01 01 01 01 01 01 01 01 01 01 01 00
00 01 01 01 01 01 01 01 01 01 01 01 01 01 01 01 01 01 01 01 01 01 01 01 01 01 01 01 01 01 01 00
00 01 01 01 01 01 01 01 01 01 01 01 01 01 01 01 01 01 01 01 01 01 01 01 01 01 01 01 01 01 01 00
00 01 01 01 01 01 01 01 01 01 01 01 01 01 01 01 01 01 01 01 01 01 01 01 01 01 01 01 01 01 01 00
00 01 01 01 01 01 01 01 01 01 01 01 01 01 01 01 01 01 01 01 01 01 01 01 01 01 01 01 01 01 01 00
00 01 01 01 01 01 01 01 01 01 01 01 01 01 01 01 01 01 01 01 01 01 01 01 01 01 01 01 01 01 01 00
00 01 01 01 01 01 01 01 01 01 01 01 01 01 01 01 01 01 01 01 01 01 01 01 01 01 01 01 01 01 01 00
00 01 01 01 01 01 01 01 01 01 01 01 01 01 01 01 01 01 01 01 01 01 01 01 01 01 01 01 01 01 01 00
00 01 01 01 01 01 01 01 01 01 01 01 01 01 01 01 01 01 01 01 01 01 01 01 01 01 01 01 01 01 01 00
00 01 01 01 01 01 01 01 01 01 01 01 01 01 01 01 01 01 01 01 01 01 01 01 01 01 01 01 01 01 01 00
00 01 01 01 01 01 01 01 01 01 01 01 01 01 01 01 01 01 01 01 01 01 01 01 01 01 01 01 01 01 01 00
00 01 01 01 01 01 01 01 01 01 01 01 01 01 01 01 01 01 01 01 01 01 01 01 01 01 01 01 01 01 01 00
00 01 01 01 01 01 01 01 01 01 01 01 01 01 01 01 01 01 01 01 01 01 01 01 01 01 01 01 01 01 01 00
00 01 01 01 01 01 01 01 01 01 01 01 01 01 01 01 01 01 01 01 01 01 01 01 01 01 01 01 01 01 01 00
00 01 01 01 01 01 01 01 01 01 01 01 01 01 01 01 01 01 01 01 01 01 01 01 01 01 01 01 01 01 01 00
00 01 01 01 01 01 01 01 01 01 01 01 01 01 01 01 01 01 01 01 01 01 01 01 01 01 01 01 01 01 01 00
00 01 01 01 01 01 01 01 01 01 01 01 01 01 01 01 01 01 01 01 00 01 01 01 01 01 01 01 01 01 01 00
00 01 01 01 01 01 01 01 01 01 01 01 01 01 01 01 01 01 00 00 00 00 01 01 01 01 01 01 01 01 01 00
00 01 01 01 01 01 01 01 01 01 01 01 01 01 01 01 01 01 01 00 00 00 00 01 01 01 01 01 01 01 00 00
00 01 01 01 01 01 01 01 01 01 01 01 01 01 01 01 01 01 01 01 00 00 01 01 01 01 01 01 00 00 00 00
00 01 01 01 01 01 01 01 01 01 01 01 01 01 01 01 01 01 01 01 01 00 01 01 01 01 01 01 01 00 00 00
00 01 01 01 01 01 01 01 01 01 01 01 01 01 01 01 01 01 01 01 01 01 01 01 01 01 01 01 01 01 00 00
00 01 01 01 01 01 01 01 01 01 01 01 01 01 01 01 01 01 01 01 01 01 01 01 01 01 01 01 01 01 01 00
00 01 01 01 01 01 01 01 01 01 01 01 01 01 01 01 01 01 01 01 01 01 01 01 01 01 01 01 01 01 01 00
00 01 01 01 01 01 01 01 01 01 01 01 01 01 01 01 01 01 01 01 01 01 01 01 01 01 01 01 01 01 00 00
00 01 01 01 01 01 01 01 01 01 01 01 01 01 01 01 01 01 01 01 01 01 01 01 01 01 01 01 01 00 00 00
00 01 01 01 01 01 01 01 01 01 01 01 01 01 01 01 01 01 01 01 01 01 01 01 01 01 01 00 00 00 00 00
00 01 01 01 01 01 01 01 01 01 01 01 01 01 01 01 01 01 01 01 01 01 01 01 01 01 00 00 00 00 00 00
00 01 01 01 01 01 01 01 01 01 01 01 01 01 01 01 01 01 01 01 01 01 01 01 01 00 00 00 00 00 00 00
00 01 01 01 01 01 01 01 01 01 01 01 01 01 01 01 01 01 01 01 01 01 01 01 00 00 00 00 00 00 00 00
00 00 00 00 00 00 00 00 00 00 00 00 00 00 00 00 00 00 00 00 00 00 00 00 00 00 00 00 00 00 00 00
entities
00 00 00 00 00 00 00 00 00 00 00 00 00 00 00 00 00 00 00 00 00 00 00 00 00 00 00 00 00 00 00 00
00 00 00 00 00 00 00 00 00 00 00 00 00 00 00 00 00 00 00 00 00 00 00 00 00 00 00 00 00 00 00 00
00 00 01 00 00 00 00 00 00 00 00 00 00 00 00 00 00 00 00 00 00 00 00 00 00 00 00 00 00 00 00 00
00 00 00 00 00 00 00 00 00 00 00 00 00 00 00 00 00 00 00 00 00 00 00 00 00 00 00 00 00 00 00 00
00 00 00 00 00 00 00 00 00 00 00 00 00 00 00 00 00 00 00 00 00 00 00 00 00 00 00 00 00 00 00 00
00 00 00 00 00 00 00 00 00 00 00 00 00 00 00 00 00 00 00 00 00 00 00 00 00 00 00 00 00 00 00 00
00 00 00 00 00 00 00 00 00 00 00 00 00 00 00 00 00 00 00 00 00 00 00 00 00 00 00 00 00 00 00 00
00 00 00 00 00 00 00 00 00 00 00 00 00 00 00 00 00 00 00 00 00 00 00 00 00 00 00 00 00 00 00 00
00 00 00 00 00 00 00 00 00 00 00 00 00 00 00 00 00 00 00 00 00 00 00 00 00 00 00 00 00 00 00 00
00 00 00 00 00 00 00 00 00 00 00 00 00 00 00 00 00 00 00 00 00 00 00 00 00 00 00 00 00 00 00 00
00 00 00 00 00 00 00 00 00 00 00 00 00 00 00 00 00 00 00 00 00 00 00 00 00 00 00 00 00 00 00 00
00 00 00 00 00 00 00 00 00 00 00 00 00 00 00 00 00 00 00 00 00 00 00 00 00 00 00 00 00 00 00 00
00 00 00 00 00 00 00 00 00 00 00 00 00 00 00 00 00 00 00 00 00 00 00 00 00 00 00 00 00 00 00 00
00 00 00 00 00 00 00 00 00 00 00 00 00 00 00 00 00 00 00 00 00 00 00 00 00 00 00 00 00 00 00 00
00 00 00 00 00 00 00 00 00 00 00 00 00 00 00 00 00 00 00 00 00 00 00 00 00 00 00 00 00 00 00 00
00 00 00 00 00 00 00 00 00 00 00 00 00 00 00 00 00 00 00 00 00 00 00 00 00 00 00 00 00 00 00 00
00 00 00 00 00 00 00 00 00 00 00 00 00 00 00 00 00 00 00 00 00 00 00 00 00 00 00 00 00 00 00 00
00 00 00 00 00 00 00 00 00 00 00 00 00 00 00 00 00 00 00 00 00 00 00 00 00 00 00 00 00 00 00 00
00 00 00 00 00 00 00 00 00 00 00 00 00 00 00 00 00 00 00 00 00 00 00 00 00 00 00 00 00 00 00 00
00 00 00 00 00 00 00 00 00 00 00 00 00 00 00 00 00 00 00 00 00 00 00 00 00 00 00 00 00 00 00 00
00 00 00 00 00 00 00 00 00 00 00 00 00 00 00 00 00 00 00 00 00 00 00 00 00 00 00 00 00 00 00 00
00 00 00 00 00 00 00 00 00 00 00 00 00 00 00 00 00 00 00 00 00 00 00 00 00 00 00 00 00 00 00 00
00 00 00 00 00 00 00 00 00 00 00 00 00 00 00 00 00 00 00 00 00 00 00 00 00 00 00 00 00 00 00 00
00 00 00 00 00 00 00 00 00 00 00 00 00 00 00 00 00 00 00 00 00 00 00 00 00 00 00 00 00 00 00 00
00 00 00 00 00 00 00 00 00 00 00 00 00 00 00 00 00 00 00 00 00 00 00 00 00 00 00 00 00 00 00 00
00 00 00 00 00 00 00 00 00 00 00 00 00 00 00 00 00 00 00 00 00 00 00 00 00 00 00 00 00 00 00 00
00 00 00 00 00 00 00 00 00 00 00 00 00 00 00 00 00 00 00 00 00 00 00 00 00 00 00 00 00 00 00 00
00 00 00 00 00 00 00 00 00 00 00 00 00 00 00 00 00 00 00 00 00 00 00 00 00 00 00 00 00 00 00 00
00 00 00 00 00 00 00 00 00 00 00 00 00 00 00 00 00 00 00 00 00 00 00 00 00 00 00 00 00 00 00 00
00 00 00 00 00 00 00 00 00 00 00 00 00 00 00 00 00 00 00 00 00 00 00 00 00 00 00 00 00 00 00 00
00 00 00 00 00 00 00 00 00 00 00 00 00 00 00 00 00 00 00 00 00 00 00 00 00 00 00 00 00 00 00 00
00 00 00 00 00 00 00 00 00 00 00 00 00 00 00 00 00 00 00 00 00 00 00 00 00 00 00 00 00 00 00 00