id
3
name
The Forest
size
12 1
tiles
01 01 01 01 01 01 01 01 01 01 01 01
colors
01 01 01 01 01 01 01 01 01 01 01 01
functions
00 00 00 00 00 00 01 01 00 00 00 00
walkable
01 01 01 01 00 00 00 00 00 00 00 00
entities
01 00 00 00 00 00 00 00 00 00 00 00